1111111111111
1P00000000001
1011111100001
1000000011111
1011111000001
1000000111111
1011111000001
1000000111111
1011111111111
1E00000000001
1111111111111
