1111111111111
1P00001111101
1011111111111
1000000000001
1111111000011
1E00000111111
111111111C111
1000000000001
1011111100001
1E00001111111
1111111111111
